19
__o_op_________
_wo____________
________w______
_____________o_
______o__p___o_
w______o_w_____
oppp______op__p
__wop___p____p_
wow______wpw_p_
_wpo_____wp____
______w_w$_____
____p_____p____
w__wwp______ooo
_____ow______p_
o____p_wo_w_o__
