19
___o_o______p__
___woo_______ow
_oop___________
_w_____w_____w_
________p___op_
______ow___p___
__o_w_w____p___
________o_____p
__wo___wo_pop__
___p___p__$____
p_________po___
__p______w_w___
w__________w___
_____p_wwpo__p_
o_o_wpw_w___o_p
