19
____o____p_____
_p__w_ww_w_____
o_____pwo_o_p__
p___$ww__w____p
___p_o__o______
___p___________
w___o_o____o___
p___p__w_______
____w____w___p_
____owo__p____o
_o_____po____p_
_o___oo______wo
_____p_ow__p___
_p______ww___w_
_____p__p_w____
