66
_pp___p_o_op_p______
__o____wo_oowpp__ppo
p_w_opo_po__p__p_pp_
__pwwpo__p____p__ow_
o__pp_o__wo_ww__oo_w
o_opo_o____o____w___
__wpw__p__o_wwwpo___
o_wow__ww_wwpoppop_w
___wpp_ppowp__owo___
__p_pw$o_o___p_wo_pp
o__pww_w__wp___po_o_
p__w____wp___wpp_p_o
wowoop_p_o___w_oww_w
_wp_p_wo______w_w___
__o_o_o_wp_w_wo__o__
_pwp______o__o_o__ww
ow_wo_po_____poo__wp
__p_____o__ow_w___ow
o__pww_oo_w__wp_p_ww
_p__opow_w_op___p_w_
