66
_w_wo_o__p_o_woow__w
o_pw___ow_ww__o_p_po
pppo___w___pwpwp_op_
__o_p____w____pp___w
__wop_ppw_wpw____opw
_w_w_wo_w___w___opo_
_____o___ppppop_pppw
wooowwo_pp_____ow_po
____pw_o__ow__op____
o__ow___po_oww_____p
w_pp__p$___w__w__w__
__o__p__oopw_o____p_
wowowp_p__owwp_op_wp
__p_o_o___p______ppp
_owow_o____wow_p_o_o
po_w__poo_wo___ww___
__wpw_op___woo__o_p_
_o_pw_w_wp__po_w_wo_
wop____w___p___wo_o_
_p_p_op_wp___wo_oo__
