16
___w_o_ppw
op_o__p_oo
__p___p_w_
w_p__oo_w_
w__p__opwp
o_o__p_www
pw$__oww_p
ww_w__o__p
_o________
pp__oo_o__
