16
_____p____
po_wo_pw_o
pow___w_pw
_pww____oo
pow_owpw__
_o_p_pw__w
owpp__$_o_
_p_o__w__w
o__ow_o_o_
_pp____p__
