8
_o__w_____
_wp_______
__w_p__o__
__o_____p_
__$w_w_op_
___p__p_w_
__________
____wow___
___po_____
__po___o__
