8
____opwo__
wopw__o_w_
________p_
_________p
__p______$
w__ow____o
______o___
________pw
___w_____p
o_____p___
