8
____o___po
w______o__
oo______p_
___p______
p__w_____p
_________w
________pw
___w$o_w__
___wpwo___
___o__p___
