3
_____o____
___p______
______$__w
_________o
_________w
__________
___o______
____w_____
__________
p__p______
