3
_______o__
____p_____
________pw
__________
__o__p____
____$_____
___o______
w_________
____w_____
__________
