52
_p_wwo_pw_o_o__w_w___w___
w___________o____$o__p___
___o_p______op________w__
w__w________po____ww__p__
_________w_p______o____p_
_____o_p_o_______o_op____
____o_____wp__pp_ow_o_o__
__pw__pow___ww__wo_____pp
__wo__w__w__oppo_p______w
_w__pp__pw__o_o______w_wo
wp___p___________p_______
o_p_____op___p___pw___o__
____p____w___o___o__o_po_
_ow______o__ow__p___wo___
____w__ww_op____o________
________w__________o_____
_____p_________o____o____
___o___p__p______o_p_www_
_w_pw__o_p___wp__________
o_______p_o___w__________
_____________op__p___ow__
p______w_______________w_
w___p_o___o______________
___wp______o___w_p____o_p
________p__________w___p_
