52
__p__p__w__ooo__pwp__wo__
__w_______ppo_o___p__w___
__p_______o__w__p__wow___
_____________________p___
_o_____p_w_p______pp_____
_____op___o_w_op____pw_o_
___o___o___w__p_p__p_____
_p__ow__op_____o_op___wp_
ow_______oo__p__o___p____
___o__w___ww_________p__o
_____o____________pp_____
_p__op__woo_____o____p__o
___________oo_o__o___w___
______w_________p____p__p
_po___p_____w____o_w___oo
____________o______wwpw__
____w___________o_ww_____
__p__w_ww______w___p_wwp_
ww_o_____w_____w_p___ow_o
___o_______p_o___p_______
_____o___wp___________w_p
_p_o__w___p_______p______
________o______ww________
___p_____$w_________opw_w
___________o__w__pwwo_w__
