52
_______p____p__w_______pw
_o$__w_p____o_p_________w
_______w_w_w__pw___o___w_
w______pop_______o__p___o
___w_wo__w___oo___p_o_wp_
w__ow__w______p_o_______o
_____w____w______________
_______o_p________w___ww_
oo_________________o__wp_
________o__p___o_______p_
__________w__________p_o_
w_pp_o____p_w____ww___p_p
__w_o__o______________p__
__w__p_wp__poo____w_pow_o
o___po__o__p__________o_o
p_o____p__wp___p___oowp_o
____p_______o______w_w___
___po________op___ww_____
______po_________o___p_o_
______owp_______w_o__ow__
ow___p_______o___w_p_____
___ow_____p______pw__w___
________________w_______o
___p___w_____oppop_____w_
p_oppw______p________w___
