33
__wo__w____p_w______
_o_____o____pw__w___
____________w_______
p_po___o________p___
p_oo_w________o_p__p
_p___w_____$________
w___p______p____o___
______w_____opw_____
______ow____________
___w__w_w_p_p_______
__p_____w__ww______p
_p___w_____p____p__o
w__w________w_o____p
___o_p____o____wppp_
__wo__o_o_____o__w_o
o___p__o_____o______
_w_____w___p_p__ow_o
p__oww__o__po_o_____
p___o_p_____op_____o
_w_____o__w____w___p
