33
___________pppo__p__
pow________w____w_p_
__o_o___w___________
___p____pp__ow___wpp
_ww_wo$___owow_____p
____________________
p___o__________p_pwo
_____p___w__w_______
___________p__oo__w_
_ppo______p__o___o__
p_op___ow_w____ow_o_
________o_p__p__o___
_o___ww__wp____o____
___w___wow_______o_o
op_p_____p______o_w_
______o__o_w___op___
_______p__________wo
_________________w__
_________pp_w_______
_ww___p_w____w_o____
