33
__p____o___o__w_____
______p_o_o___wwp_p_
_w_____w__p_w______w
____p___________o___
$__ow____p_w__p__w__
___w_________p__w___
__p_p________pp_____
_o______o_w__pw____w
____p___w____oo_____
o_____pw__o___p___w_
______p_o___po______
_w_o_p__o__p_woo____
_w___wo________o____
_oop________________
w___p__o____o_w_pw__
___p____p_ow____o___
____w________p______
____o_p_____p__ww_w_
____o_o__o__wop_w_o_
__p_p_____wp___o____
